NO ./textures/north.xpm
SO ./textures/south.xpm
WE ./textures/west.xpm
EA ./textures/east.xpm

F 35,40,41
C 117,115,108

1111111111111111111111
1111111111111111111111
1100111001100000001111
1100111000000011001111
1100111001111110001111
1100111001111000011111
1100000E01110001111111
1100000000000011111111
1111111001100111111111
1111111001100111111111
1111111001100000000011
1111111111111111111111