NO ./textures/north.xpm
SO ./textures/south.xpm
WE ./textures/west.xpm
EA ./textures/east.xpm


F 35,40,41
C 117,115,108


        11111111111111111111111111
        10000000001100000000000011111111111111111111111111111
        1011000001110000000000001
        1001000000000000000000001
111111111011000001110000000000001
100000000011000001110111111111111
11110111111111011100000010001
11110111111111011101010010001
11000000110101011100000N00001
10000000000000001100000010001
10000000000000001101010010001
1100000011101010111110111100111
11110111 1110101 101111010001
11111111 1111111 111111111111
